{
    "Tiles": [
        [1, 1, 1, 0, 0, 0, 1, 1, 1],
        [1, 1, 1, 0, 0, 0, 1, 1, 1],
        [1, 1, 1, 0, 0, 0, 1, 1, 1],
        [1, 1, 1, 0, 0, 0, 1, 1, 1],
        [1, 1, 1, 0, 0, 0, 1, 1, 1],
        [1, 1, 1, 0, 0, 0, 1, 1, 1],
        [1, 0, 0, 0, 0, 0, 0, 0, 1],
        [1, 0, 0, 0, 0, 0, 0, 0, 1],
        [1, 0, 0, 0, 0, 0, 0, 0, 1]
    ],
    "TileTypes": [
        {
            "Key": 0,
            "ColorName": "tan",
            "HeightName": "floor"
        },
        {
            "Key": 1,
            "ColorName": "gray",
            "HeightName": "wall"
        }
    ]
}